########################################
#......................................#
#.####################################.#
#.#.....................######......##.#
#.#.###################.##.....####..#.#
#.#.####...........###..#..#########.#.#
#.#....#.#####.###.###.##.##.........#.#
#.####.#.#.....###.###.##.#..#########.#
#.###..#.#.#####...#...##.#.##.........#
#.###.##.#.#*...####.####.#.#..#########
#.###..#.#.#.##......#....#...##.......#
#.####.#.#.#..#.######.########..#####.#
#.#....#.#.##...#......#........#......#
#.#.####.#.######.######.########.######
#.#......#........#....#......#...#....#
#.#################.##..#####.#.##..##.#
#...................###.......#....##..#
#####################################.##
#.....................................##
########################################